+-+-+-+-+-+-+-+-+-+-+-+-+-+-+-+-+-+-+-+-+-+-+-+-+-+
          |     | |       |       |         |     |
+ +-+-+-+ + + + + + +-+-+ + +-+-+ + + +-+-+ + +-+ +
|     | | | | | |   |     |     | | | |   | |   | |
+-+-+ + + + +-+ +-+-+ +-+-+-+-+ +-+ + + +-+ +-+ + +
|     | | | |   |     |       |   | | |   |   | | |
+ +-+-+ + + + +-+ +-+-+ +-+ +-+-+ + + + + +-+ + + +
|   |     | |   | |   |   |   | |   |   | |   | | |
+-+ + +-+ + + +-+ + + +-+ +-+ + +-+-+-+-+ + +-+-+ +
|   | |   | |     | |     | | |   |       |   |   |
+ +-+-+ +-+ +-+-+-+ +-+-+-+ + +-+ + +-+-+ +-+ + +-+
| |   |   |   |   | |   |   | |   |     | |   | | |
+ + + +-+ +-+ +-+ + + + + + + + +-+-+-+ + +-+-+ + +
| | |   |     |   |   | | | | | |   |   |       | |
+ +-+-+ +-+-+ + +-+-+-+ + +-+ + +-+ + +-+-+ +-+-+ +
|   | | |   |   |   |   |   | |   |   |   | |   | |
+-+ + + + + +-+ + + +-+-+ + + + + +-+-+ + + + + + +
|     |   |   |   | |   | | | | |   |   | | | | | |
+-+-+ + +-+-+ +-+-+ + + + + + + +-+ + +-+-+ + + + +
|     | |   |   | |   |   |     |   |   |     |   |
+ +-+-+ + + +-+ + +-+-+-+-+-+-+-+ +-+ + + +-+-+-+-+
| |   | | | |   |         |     |     | |   |     |
+ + + + + + + + + +-+-+-+ + +-+ +-+-+-+ +-+ + +-+ +
|   | | | |   | | |   | | | |   |   |   |   | |   |
+ +-+-+ + +-+-+-+ + + + + + + +-+ + + +-+ +-+-+ +-+
| |     |   |     | |     | | |   | | |   |   |   |
+ + +-+-+-+ + +-+-+ +-+-+-+-+ + +-+ + + +-+-+ + + +
|   |   |     |   |     |     | |   | | |   | | | |
+-+-+ + + +-+-+-+ +-+ + + +-+-+ + +-+-+ + + + + + +
|     | |   |   | |   |   |     |   |   | | | | | |
+ +-+-+ +-+ + + + + +-+-+-+ +-+-+-+ + + + + + + +-+
|     | |   | |   |         |       | | | |   |   |
+-+ + +-+ +-+ +-+-+-+ +-+ +-+ +-+-+-+ +-+ +-+-+-+ +
|   |       |   |     |   |   |   |     |         |
+ +-+-+-+-+ +-+ + +-+-+ +-+ + + + + + + + +-+-+-+-+
| |       | |   |     |   | | | |   | | | |   |   |
+ + + +-+ +-+ +-+-+-+ +-+ + +-+ +-+-+ + + + +-+ + +
| | |   | |   |     | |   |     |     |   |     | |
+ + +-+-+ + +-+ + +-+ +-+-+-+-+-+ + +-+-+-+ +-+-+-+
|   |     |     |   |   |     |   | |             |
+-+-+ +-+-+ +-+-+-+ + + + +-+ + +-+-+ +-+-+-+-+-+ +
|   | |   | |   | | | | | |   | |   |           | |
+ +-+ + + + + + + + +-+ + + +-+ + + +-+-+-+-+-+-+ +
| |   | | |   | | |       | | |   |       |   |   |
+ + +-+-+ +-+-+ + +-+-+ +-+ + +-+-+-+ +-+-+ + + +-+
|   |     | |   | | |     | |   |   |     | | | | |
+ +-+ +-+-+ + +-+ + + +-+-+ +-+ + + +-+-+ + + + + +
| |   |   | | | | | |   |       | | |   |   |   | |
+ + +-+ + + + + + + +-+ + +-+-+-+ + + + +-+-+-+-+ +
|   |   |       |       |         |   |
+-+-+-+-+-+-+-+-+-+-+-+-+-+-+-+-+-+-+-+-+-+-+-+-+-+